0 0 0 0 20 0 0 0 0 1
0 0 0 0 0 0 0 210 0 1
0 0 0 0 100030 0 0 0 0 1
0 0 0 0 0 0 0 0 0 0
0 310 0 0 0 0 0 0 200030 0
0 0 0 0 0 22 0 0 0 0
20 0 0 0 0 0 0 0 0 0
0 0 110 0 0 0 0 0 410 0
0 0 0 0 0 300030 0 0 1 1
0 0 0 0 0 0 0 0 1 1